000000000000000000000000000000000000000000000000000000000000000000000000000000000000000000000000000000000000000000000220000000000000000000000000000000000000000000000000000
000000000000000000000000000000000000000000000000000000000000000000000000000000000000000000000000000000000000000000000000000000000000000000000000000000000000000000000000000
000000000000000000000000000000000000000000000000000000000002000000000000000000000000000000000000000000000000000000000000000000000000000000000000000000000000001100000000000
000000000000000000000000000000000000000000000000000000011111110000000000000000000000000000000000000000000000000000000000000000000000000000000000000000001100000000000000000
000000000000000000000000000000000000000000000000001110000000000000000000000000000000000000000000000000000000000110000000000000000000000011000000001100000000000000000000000
000000000000000000000000000000000000000000000110000000000000000000000000000000000000000000000000000000000000000000000000000000000011000000011000000000000000000000000000000
000000000000000000000000000000000000000011000000000000000000000000000000000000000000000000000110000002000000000000000000000011000000000000000000000000000000000000000000003
000000000000000000000022000000000001100000000000000000000000000000020000220000220000000001100000110001111100000000000011000000000000000000000000000000000000000001111111111
000000000000000001111111111111112222222222222222222222221111111111111111111111111111122222222222222222222211111111111122222222222222222222222222222222222222222222222222222
