0000000000000000000000000000000000000000000000000000000000000000000000000000000000000000000000000000000000000000000000000000000000000000000000000000000000
0000000000000000000000000000000000000000000000000000000000000000000000000000000000000000000000000000000000000000000000000000000000000000000000000000000000
0000000000000000000000000000000000000000000000000000000000000000000000000000000000000000000000000000000000000000000000000000000000000000000000000000000000
0000000000000000000000000000000000000000000000000000000000000000000000022000000000000000000000000000000000000000000000000000220000000000000000000000000000
0000000000000000000000000000000000000000000000000000000000000000000111111111100000000000000000000000000000000000000000001111111111000000000000000000000000
0000000000000000000000000000000000000000000000000000000000000111000000000000001100020000000000000000000000000020001110000000000000011000002000000000000000
0000000000000000000000000000000000000000000000000000000111000000000000000000000000011110000000000000000000011110000000000000000000000001111100000000000000
0000000000000000002200000022000000002000000000000111000000000000000000000000000000000000110000000000011100000000000000000000000000000000000000110000000003
0000000000000111111111111111111111111111111111222222222222222222222222222222222222222222222111111112222222222222222222222222222222222222222222222111111111
