000000000000000000000000000000000000000000000000000000000000000000000000000000000000000000000000000000000000000000000000000000000000000000000000000000000000000000000000000000000000000000000000000000000000000000000000
000000000000000000000000000000000000000000000000000000000000000000000000000000000000000000000000000000000000000000000000000000000000000000000000000000000000000000000000000000000000000000000000000000000000000000000000
000000000000000000000000000000000000000000000000000000000000000000000000000000000000000000000000000000000000000000000000000000000000000000000000000000000000000000000000000000000000000000000000000000000000000000000000
000000000000000000000000000000000000000000000000000000000000000000000000000000000000000000000000000000000000000000000000000000000000000000000000000000000000000000000000000000000000000000000000000000000000000000000000
000000000000000000000000000000000000000000000000000000000000000000000000000001000000000000000000000000000000000000000000000000000000000000000000000000001000000000000000000000000000000000000000000022000000000000000000
000000000000000000000000000000000000000000000000010000000000000220000000100000000000000000000000000000000000000000000000000000000000000000000000000100000000000000000000000000000000000000000000011111111000000000000000
000000000000000000000000000000000000000000001000000100000001111111110000000000000000000000000200000000000000000000000000010000000000000000000010000000000000000000000000000000000000000000001000000000000000000000000000
000000000000000000222000000022000000000100000000000001100000000000000000000000022200000000000111110000000022000000001000000100002000000001000000000000000000000220000000022200000000000100000000000000000000000000000003
000000000111111111111111111111111112222222222222222222222222222222222222222222211111111111222222222222111111111122222222222221111111122222222222222222222211111111111111111111111112222222222222222222222211111111111111
